================
= X $$ %¨   XX =
===== %%% $$$  =
= ========  ====
= %            =
================